abandon	포기하다, 버리다	감정과 상태
absently	멍하니, 방심하여	감정과 상태
absorb	흡수하다	동작
abundance	풍부, 대량	수와 양
accessible	접근할 수 있는, 이용 가능한	모양과 상태
accurate	정확한, 올바른	모양과 상태
admirable	훌륭한, 칭찬할 만한	사람
alienation	소외, 양도	장소
alternate	번갈아 하다, 교대의	직업
apart from~	~와 분리되어	장소
appropriate	충당하다, 적당한	모양과 상태
aquarium	수족관, 수조	도구 및 사물
assembly line	조립 라인	직업
assignment	과제, 임무	직업
assure	보장하다, 확인하다	감각과 지각
attention	관심, 집중	감각과 지각
auditory	청각의, 청력의	감각과 지각
available	가능한, 이용할 수 있는	모양과 상태
avoid	피하다	동작
await	기다리고 있다, 기대하다	동작
bargain	흥정하다, 헐값	경제활동
batter	타자, 공격하다	사람
be equal to	~와 같다, 와 동등하다.	모양과 상태
be exposed to	~을 향하고 있다	장소
be supposed to do	하기로 되어 있다	시간과 때
be touched	감동 받다	감정과 상태
be used to	하는데 익숙하다.	직업
belongings	소유물	도구 및 사물
benefit	이익, 혜택	경제활동
beverage	음료, 마실 것	요리와 음식
biography	전기, 자서전	사람
bounce	회복하다, 되돌아오다	건강과 질병
boundless	무한한, 드넓은	수와 양
budget	예산	경제활동
bumpy	울퉁불퉁한, 평탄치 않은	모양과 상태
bunch	다발, 무리	수와 양
burst	터지다, 폭발하다	모양과 상태
catch up	따라잡다, 밀린 일을 하다	직업
category	범주, 분류	수업
centrality	중심적인 역할	국가와 사회
charge	혐의, 요금	법과 범죄
circumstances	환경	환경
clarity	명쾌함, 맑음	모양과 상태
combination	조합, 결합	모양과 상태
come up with	찾아내다, 내놓다, 제안하다	감각과 지각
commentary	주석, 논평	수업
companion	친구, 동반자	사람
compensation	보상, 보상금	법과 범죄
compete for	~을 위해 와 싸우다, 경쟁하다	국가와 사회
complete	완성된, 완료하다	모양과 상태
compliment	칭찬하다	문화
compost	비료를 주다, 퇴비	직업
conduct	실시하다, 수행하다	동작
connect	연결하다, 이어지다	모양과 상태
consequently	결과적으로, 그 결과로서	연결어
consist in	~에 있다.	모양과 상태
contemporary	동시대의, 최신의	시간과 때
context	문맥, 상황	수업
conventional	전통적인, 틀에 박힌	문화
convince	설득하다, 확신시키다	사람
correspondence	보고, 연락	직업
costly	사치스러운, 값비싼	경제활동
coverage	보상 범위, 적용 범위	위치와 방향
crash	충돌하다, 추락하다	동작
decline	감소하다, 하락하다	경제활동
defect	결함, 탈주	국가와 사회
delay	지연시키다, 늦추다	시간과 때
deliberately	고의로, 일부러	연결어
demonstrate	시위하다, 입증하다	국가와 사회
depart	떠나다, 벗어나다	동작
department	부, 부서, 과	직업
dependent	의존하는, 의지하는	감정과 상태
derive from	~에서 유래를 찾다, 유래하다.	시간과 때
deserve	자격, 마땅히	직업
desperate	필사적인, 절망적인	감정과 상태
desperately	필사적으로, 절실하게	감정과 상태
disappear	사라지다, 없어지다	모양과 상태
discomfort	불안, 불편	감정과 상태
display	보여주다, 진열하다	동작
diverse	다양한, 여러 가지의	모양과 상태
dizzy	어지러운, 현혹시키다	감각과 지각
dorsal	등의, 등 부분의	신체
draw on	~에 의지하다, 끼다	감정과 상태
drop by	얼굴 내밀기, 들르다	동작
due	예정인, 때문에	연결어
duration	지속기간, …동안	시간과 때
ease	완화하다, 덜어주다	모양과 상태
ecosystem	생태계	환경
edge	가장자리, 끝	위치와 방향
effective	효과적인	경제활동
elaborate	상세히 말하다, 정교한	모양과 상태
encyclopedia	백과사전	도구 및 사물
enforceable	실행할 수 있는	
engage in	종사하다, 시작하다	직업
eventually	결국, 마침내	연결어
exhibition	전시, 작품, 박람회	문화
exotic	이국적인, 외국의	문화
experiment	실험, 시도	수업
extremely	극도로, 매우	연결어
facilitate	촉진하다, 쉽게 하다	
facility	시설, 재능	도구 및 사물
fall off	떨어지다, 물러나다	동작
flattering	아첨하는, 기쁘게 하는	사람
flood into	~로 밀려들다, 몰려들다.	모양과 상태
frustrated	낙담한, 좌절된	감정과 상태
fundamentally	근본적으로, 기본적으로	연결어
furnish	갖추다, 제공하다	동작
gaze at	~을 응시하다	동작
genetics	유전학, 유전적 특징	수업
geographical	지리적인, 지리학적	수
give away	거저 주다, 누설하다, 무너져 내리다	동작
go into theweather	풍우를 무릅쓰고 나가다	감정과 상태
grateful	감사하는, 고마운	감정과 상태
heap	더미, 쌓다	수와 양
heartland	중심 지역, 핵심 지역	장소
homely	가정적인, 편안한	감정과 상태
hygrometer	습도계	도구 및 사물
identification	신분증, 신원 확인	사람
imaginary	상상의, 가상의	감각과 지각
imaginative	상상의, 창의적인	감각과 지각
imperfect	불완전한, 결함이 있는	모양과 상태
imply	암시하다, 함축하다	감각과 지각
in person	직접의, 실제로 하는	사람
in place of	대신, 대신에	연결어
in terms of	면에서, 관점에서	연결어
incredible	엄청난, 믿을 수 없는	감정과 상태
independent	독립한, 자유의	모양과 상태
indifferent	무관심한, 중요치 않은	감정과 상태
infected	감염된, 오염된	환경
inspire	영감을 주다, 고취하다	감정과 상태
instead	대신에, 보다	연결어
integral	완전한, 필수의	연결어
intensity	강렬함, 중요성	모양과 상태
intently	집중하여, 열심히	감정과 상태
interchange	~을 주고받다, 교환하다	동작
interdependence 	상호 의존	모양과 상태
interpretation	해석, 통역	직업
investment	투자, 출자	경제활동
involve	관련되다, 참여하다	동작
irrelevant	관계가 없는, 부적절한	모양과 상태
issue	문제, 사안	국가와 사회
itch	가렵다, 못 견디다	신체
long for	~을 갈망하다, 간절히 원하다.	감정과 상태
magnificent	웅장한, 훌륭한	모양과 상태
make use of	~을 이용하다	동작
manipulative	뜻대로 조종하는	감각과 지각
massive	대규모의, 거대한	수와 양
measure up to	길이[폭, 높이]가 에 달하다	수와 양
memorable	기억할 만한, 인상적인	감각과 지각
muscle	근육	신체
mutual	상호적인, 공동의	모양과 상태
namely	즉, 소위	연결어
narration	서술, 이야기	문화
negative	부정의, 비판적인	문화
neutral	중립	위치와 방향
norm	기준, 표준	국가와 사회
notion	생각, 개념	문화
onstage	무대 위의	문화
organic	유기적인, 근본적인	자연
outdated	구식의, 시대에 뒤진	문화
output	출력, 생산	경제활동
overhear	우연히 듣다, 엿듣다	신체
overwhelming	압도적인, 굉장한	모양과 상태
participant	참가자, 참석자	사람
party	정당, 파티, 단체	국가와 사회
patience	인내, 참을성	사람
perceptual	직관을 가진, 지각이 있는	감각과 지각
period	기간, 시기	시간과 때
photon	광자, 광양자	자연
physicist	물리학자, 자연 과학자	사람
pile	쌓다, 모으다	수와 양
potential	잠재적인, 가능성 있는	모양과 상태
practically	사실상, 실제로	연결어
precious	소중한, 귀중한	모양과 상태
prescription	처방	건강과 질병
present	현재의, 보여주다, 선물하다	모양과 상태
prevalent	만연한, 널리 퍼진	모양과 상태
prevent	방지하다, 예방하다	건강과 질병
produce	~을 생산하다, 제작하다	경제활동
proper	적절한, 제대로	모양과 상태
psychologist	심리학자, 정신과 의사	사람
push around	매정하게 다루다	사람
qualifying round	예선 경기	운동
quotation	인용	문화
range	범위, 사거리	장소
rating	등급, 평가	수
recognition	인정, 승인	법과 범죄
recommendation	추천, 의견	동작
reconciliation	화해, 조정	법과 범죄
regardless of	상관없이, 관계없이	연결어
regret	후회하다, 유감	감정과 상태
relevance	관련성, 적절함	모양과 상태
relieve	완화시키다, 해소시키다	모양과 상태
remote	먼, 원격의	장소
replace	교체하다, 대신하다	동작
represent	대표하다, 보여주다	모양과 상태
reputation	명성, 평판	사람
requirement	요구, 조건	법과 범죄
reserve	보유하다, 예약하다	문화
resist	저항하다, 반대하다	법과 범죄
resolve	해결하다, 대책을 마련하다	문화
restoration	복구, 회복	모양과 상태
result in	~으로 끝나다.	모양과 상태
reverse	반대의, 바꾸다	모양과 상태
round-the-clock	끊임없이, 쉬지 않고	모양과 상태
rush to	~로 돌진하다.	동작
scatter	흩어지다, 뿌리다	동작
scenery	경치, 풍경, 무대	장소
scratch	긁다, 흠집	모양과 상태
senior citizen	노인, 고령자	사람
separated	별거 중에, 따로 떨어져 생활하여	장소
shake off	고치다, 고개를 가로저어거부하다	동작
shameless	파렴치한, 뻔뻔한	사람
significant	중요한, 상당한, 중대한	모양과 상태
single out	선발하다	동작
solitary	혼자의	사람
specificity	특이성, 특수성	모양과 상태
spectacular	장관의, 화려한	장소
split	나누다, 분열시키다	장소
standard fee	기본요금	경제활동
static	정전기, 잡음, 전파 방해	환경
statistics	통계학, 통계	경제활동
stimulating	활기를 주는, 자극적인	감각과 지각
striking	파업 중인, 두드러진	경제활동
suffer from	~으로 고통을 겪다	건강과 질병
sunset	일몰, 해질녘	시간과 때
support	지지하다, 지원하다	동작
surround	둘러싸다, 주변	장소
symptom	증상, 증세, 증후군	건강과 질병
temperature	온도, 열, 날씨	환경
tension	긴장, 갈등	모양과 상태
throw up	토하다, 급히 날아오르다	건강과 질병
toss	던지다, 쫓아내다	동작
touched	감동한, 마음이 움직인	감정과 상태
transmit	전송하다, 전염시키다	동작
tribal	종족의, 부족민	국가와 사회
ultimately	마침내, 결국	연결어
uninterrupted	연속적인, 끊임없는	모양과 상태
unresolved	미해결의, 미정의	모양과 상태
upright	똑바로, 직립한, 올바른	모양과 상태
abundance	풍부, 대량	수와 양
accurate	정확한, 정밀한	감각과 지각
achievement	성취, 업적	감정과 상태
acquire	얻다, 인수하다	경제활동
admission	입학, 입장	학교
advent	출현, 도래	모양과 상태
advertisement	광고	경제활동
affection	애정, 애착	사람
affective	정의적, 정서의	감정과 상태
alienation	소외, 양도	경제활동
anticipate	기대하다, 예상하다	감각과 지각
anxiously	걱정스럽게, 애타게	감정과 상태
approximate	대강의, 가까운	수와 양
arrogance	오만, 자만	사람
attain	달성하다, 이루다	모양과 상태
attempt to	~하려고 시도하다	사람
awareness	인식, 의식	감각과 지각
be accompanied by[with]	동반하다	동작
be influenced by	~에 영향을 받다, ~에 의해 좌우되다	모양과 상태
be liable to	~할 것 같다	모양과 상태
be regarded as	~으로 간주되다	감각과 지각
biologist	생물학자	사람
blend	혼합, 혼합물	도구와 사물
blood donor	급혈자, 헌혈자	사람
bothersome	성가신, 귀찮은	감정과 상태
breakthrough	돌파, 획기적인	모양과 상태
bring out	출판하다, 꺼내다	동작
built on	의거한, 기반을 두다	모양과 상태
bulletin board	게시판, 공고판	도구와 사물
certainty	확실, 확신	감각과 지각
chew on	씹다, 성가시게 잔소리하다	사람
circumstances	주위의 사정, 상황	환경
clarify	명백히하다, 분명해지다	모양과 상태
combustion	연소, 산화	모양과 상태
commonality	공유성, 공통성	모양과 상태
communal	공동 사회의, 공동의	국가와 사회
compensate	보상하다, 보완하다	경제활동
compete against[with]	~와 경쟁하다	경제활동
conceal	감추다, 숨기다	법과 범죄
conducive	도움이 되는, 공헌하는	국가와 사회
conflict	갈등, 분쟁	법과 범죄
contemporary	현대의, 동시대의	시간과 때
contempt	경멸, 모욕	감정과 상태
contrary to	~에 위배되는, 와 다른	법과 범죄
contribute to	~에 기부하다, 기고하다	문화
conversation	대화, 회화	문화
cooperation	협력, 협조	문화
courageous	용기 있는	사람
critical	비판적인, 중요한	감각과 지각
criticize	비난하다, 비판하다	감정과 상태
curious	궁금한, 알고 싶은	수업
curl up	뻗다, 쓰러지다	동작
definitely	분명히, 확실하게	연결어
delight	기쁘게 하다, 기쁨	감정과 상태
destination	목적지, 관광지	장소
detach from	~에서 떼어놓다	동작
determination	결심, 결정	감각과 지각
detract	딴 데로 돌리다, 줄이다	모양과 상태
diagnosed with	~라는 진단을받다	건강과 질병
disapproval	반대, 비난	국가와 사회
dissent	반대, 이의	국가와 사회
disturb	방해하다, 혼란시키다	동작
diverse	다양한, 여러 가지의	모양과 상태
donation	기부, 기증	문화
downfall	몰락, 낙하	경제활동
earnestly	진지하게, 진정으로	연결어
easygoing	느긋한, 너그러운	사람
ecological diversity	생태계 다양성	환경
economically	경제의 측면에서, 효율적으로	경제활동
embed in	~에 박아 넣다	동작
embrace	포용하다, 받아들이다	사람
emotional	감정적인, 감정의	감정과 상태
end up	결국 (어떤 처지에) 처하게 되다	모양과 상태
equilibrate	평형시키다, 평형이 되다	모양과 상태
ethnic group	인종 집단	문화
eventually	결국, 마침내	연결어
exaggeration	과장, 과장법	문화
excitedly	흥분하여, 기를 쓰고	감정과 상태
expectation	기대값, 기대치	경제활동
fatal loss	치명적인손실	경제활동
forager	약탈자, 식량 징발자	법과 범죄
foraging	수렵 채집	경제활동
foreign	외국의, 대외적인	국가와 사회
fortune	재산, 행운	경제활동
frustration	좌절, 분노	감정과 상태
fuel cell	연료 전지, 연료 탱크	도구와 사물
fundamental	기본적인, 근본적인	연결어
futile	헛된, 헛수고	동작
gather in	수확하다	경제활동
gender	성, 성별	사람
genuinely	성실하게, 순수하게	사람
gradually	점차적으로, 점점	연결어
guarantee	보장하다, 보증	경제활동
guilty	유죄의, 죄책감	법과 범죄
Habitat diversity	서식지 다양성	환경
halfhearted	마음이 내키지 않는, 열성이 없는	감정과 상태
harmonious	조화로운, 화합한	모양과 상태
hierarchy	계급 제도, 계층제	국가와 사회
hostility	적개심, 적대	감정과 상태
identical	똑같은, 동일한	모양과 상태
identification	표시, 동정	모양과 상태
identify	확인하다, 알아보다	모양과 상태
imaginary	상상의, 가상의	감각과 지각
imitate	모방하다, 흉내내다	동작
immediate	즉각적인, 즉시	시간과 때
impaired	약화된, 건강이 나빠진	건강과 질병
implication	의미, 영향	모양과 상태
imprudent	경솔한, 무분별한	감정과 상태
in a vacuum	고립되어, 외부와 격리되어	장소
in the meantime	그 사이에, 그 동안에	연결어
incentive	인센티브, 유인	경제활동
incorporate	포함하다, 결합하다	경제활동
incredible	엄청난, 놀라운	감각과 지각
indifference	무관심, 냉담	감정과 상태
individual	개인의, 개별의	국가와 사회
indubitable	의심할 여지 없는, 분명한	감각과 지각
inspiration	영감, 자극	감각과 지각
installment	할부금, 할부	경제활동
institution	기관, 협회	국가와 사회
intellectual	지적인, 지식인	사람
intent on	~에 열중하여, 전념하여	사람
interpretation	해석, 통역	직업
intricate	복잡한, 미묘한	모양과 상태
introspective	내성적인, 자기 반성의	사람
invariably	반드시, 언제나	연결어
invasion	침략, 침공	국가와 사회
irritating	짜증나는, 자극하는	감각과 지각
keep in mind	~을 마음에 담아두다, 잊지 않고 있다	감정과 상태
knowledge	지식, 아는 것	문화
lamented	한탄스러운, 애도되는	감정과 상태
longevity	장수, 수명	건강과 질병
luxuriant	풍부한, 무성한	수와 양
making money	많은 돈을 벌다 수익을 얻다	경제활동
mandatory	의무적인, 복무	법과 범죄
meaningful	의미 있는, 의미심장한	
merge	통합하다, 합병하다	경제활동
midwife	산파, 의 출산을 돕다	건강과 질병
minimal	최소의, 아주 작은	수와 양
miserably	불쌍하게, 비참하게	감정과 상태
misuse	오용, 악용	법과 범죄
molecule	분자	모양과 상태
multicultural family	다문화 가정	문화
musical instrument	악기	취미와 여가
neglect	무시, 방치하다	모양과 상태
negligence	태만, 무관심	감정과 상태
neighborhood	동네의, 이웃	장소
occupy with	바쁘게 만들다, ~을 자꾸시키다	동작
offspring	자식, 새끼	사람
on the other hand	반면에, 한편으로는	연결어
opponent	반대의, 상대	모양과 상태
opposition	야당, 반대	국가와 사회
optimal	최선의, 가장 바람직한	감정과 상태
pack into	~을 가득 메우다	동작
participant	참가자, 참여자	사람
particularly	특히, 특별하게	연결어
passive	수동적인, 소극적인	사람
percentage	포인트, 비율	경제활동
perfection	완벽, 완성	모양과 상태
personality	성격, 사람	사람
phenomenon	현상, 장관	장소
polarity	양극성, 극성	모양과 상태
politeness	공손함, 예의	문화
politically	정치적으로	국가와 사회
preferable	선호하는, 바람직한	감정과 상태
preoccupied	몰두한, 열중한	감정과 상태
preserve	보존하다, 보호하다	환경
prevailing	지배적인, 만연한	모양과 상태
primitive society	원시사회	국가와 사회
prominent	유명한, 두드러진	모양과 상태
properly	적절히, 제대로	연결어
provoke	자극하다, 유발하다	동작
psychologist	심리학자, 정신과 의사	사람
publication	출판, 간행물	경제활동
pull up	서다, 몹시 꾸짖다	동작
pursue	추구하다, 추진하다	동작
rational	합리적인, 이성적인	감각과 지각
recently	최근에, 얼마전	시간과 때
receptive	감수성이 풍부한, 잘 받아들이는	감정과 상태
recess	휴회, 휴식	취미와 여가
recur	재발하다, 되풀이되다	건강과 질병
refer to	~을 나타내다, ~와 관련있다	모양과 상태
refrigerator	냉장고, 냉동기	집과 가정생활
reinforce	보강하다, 강화하다	동작
relationship	연애관계, 관계	사람
relatively	비교적으로, 상대적으로	연결어
reliable	신뢰할 만한, 믿을 만한	사람
religion	종교, 신앙	역사와 종교
rely on	~에 의지하다	감정과 상태
remedy	구제하다, 치료하다	건강과 질병
replacement	대체, 교체	모양과 상태
resent	분개하다, 싫어하다	감정과 상태
resistant to	~에 대해 저항하는	감정과 상태
resource	자원, 부	경제활동
respondent	응하는, 응답자	사람
restrain	제한하다, 자제하다	법과 범죄
resume	재개하다, 다시 시작하다	동작
return	돌아오다, 복귀하다	동작
reward	보상, 대가	경제활동
ridicule	조롱하다, 놀리다	감정과 상태
ritual	의식, 제사	문화
rural	농업의, 시골의	장소
satisfy	만족시키다, 충족시키다	감정과 상태
saucer	접시	집과 가정생활
sea level	해수면, 평균 해면	환경
senior citizen	노인, 고령자	사람
sensory	감각의, 지각의	감각과 지각
shed light on	~을 명백히 하다, ~에 실마리를 던지다	모양과 상태
simultaneously	동시에, 일제히	연결어
social cohesion	사회적결속력	국가와 사회
social relation	사회적인 관계	국가와 사회
socially	사회적으로, 사교적으로	연결어
sociology	사회과학, 사회학	학교
solution	해결책, 방안	국가와 사회
starvation	기아, 궁핍	국가와 사회
stiffen	경직되다, 강경하다	국가와 사회
sufficiency	충분한 수, 충족	수와 양
sufficiently	충분히	수와 양
surpass	넘어서다, 앞서다	동작
surplus	흑자, 무역수지	경제활동
surprisingly	놀랍게도, 당연히	연결어
survival	생존, 살아남기	환경
symbolize	상징하다, 나타내다	모양과 상태
sympathy	동정, 공감	감정과 상태
take on	…을 고용하다, 떠맡다	경제활동
temporary	일시적인, 임시의	시간과 때
tendency	경향, 추세	모양과 상태
terse	간결한, 간단명료한	모양과 상태
principle	원리, 주의	국가와 사회
throughout	내내, 동안	시간과 때
transfer	넘겨주다, 옮기다	동작
transmit	전송하다, 전달하다	동작
traveling	순회하는, 이동하는	동작
trim	잘라내다, 다듬다	동작
typically	일반적으로, 보통은	연결어
unanimous	만장일치의	국가와 사회
uncomplicated	다른 것이 얽히지 않은, 합병증을 수반하지 않은	건강과 질병
unfortunately	불행하게도, 안타깝게도	연결어
universally	도처에, 널리, 널리 보편화하여	연결어
unwitnessed	감지되지 않은, 증인의 서명이 없는	법과 범죄
urban	도시의, 도심의	장소
variation	변화, 변형	모양과 상태
virtually	사실상, 거의	연결어
visual perception	시지각	신체
vital factor	중대 요소	환경
wandering	헤매는, 종잡을 수 없는	동작
welfare	복지, 후생	경제활동
wholehearted	충심으로부터의, 전심전력의	감정과 상태
wholly	완전히, 전적으로	연결어
worthwhile	가치있는, 할 만한	감정과 상태
write down	평가 절하, 을 적어 두다	경제활동
urge	요구하다, 해야 한다	동작
vague	모호한	감각과 지각
version	버전	문화
vertical	수직의, 세로의	모양과 상태
virtue	미덕, 덕목	문화
vivid	생생한, 발랄한	모양과 상태
yield	굴복하다, 수익률	경제활동
distribute	나누어주다, 배분하다	동작
dread	두려워하다	감정과 상태
recruit	모집하다	동작
absorb	흡수하다, 빨아들이다	동작
accelerate	가속화하다	모양과 상태
acceptance	수용, 수락	모양과 상태
access	접근, 접촉, 접속하다	모양과 상태
accomplish	성취하다, 완수하다	직업
account for	(비율)차지하다, 해명하다, 의 원인이 되다	수와 양
accountable for	~에 대해 책임이 있는	직업
achievement	업적, 성취, 달성	직업
acknowledge	인정하다	감각과 지각
acquire	배우다, 습득하다, 얻다	학교
adapt	적응하다, 조정하다, 각색하다	직업
adjust	조정하다, 적응하다	직업
adopt	채용하다, 채택하다, 입양하다	가족
adrift	표류하는, 방황하는	모양과 상태
advocacy	옹호, 지지, 변론	법과 범죄
advocate	옹호하다, 변호하다, 변호사	법과 범죄
affirm	확정하다, 확언하다	감각과 지각
allocate	할당하다	국가와 사회
altitude	고도	지구와 천문
ambiguous	모호한, 애매한, 불분명한	모양과 상태
anecdote	일화	문화
anthropologist	인류학자	직업
apparent	분명한, 명백한, 겉보기에는	모양과 상태
appetite	식욕, 욕구	건강과 질병
aptitude	소질, 적성	직업
architect	건축가	직업
arthritis	관절염	건강과 질병
ashamed	부끄러운, 창피한	사람
aspire	열망하다, 갈망하다	감정과 상태
assess	평가하다, 가늠하다	직업
assign	배치하다, 할당하다	직업
assume	가정하다	감각과 지각
astounding	놀라운, 믿기 어려운	모양과 상태
attachment	애착, 부속품, 첨부파일	도구 및 사물
attentive	주의를 기울이는, 경청하는	감각과 지각
backstroke	배영	운동
barren	척박한, 황량한	모양과 상태
oblige	의무적으로(부득이)~하도록 하다	국가와 사회
bear	떠맡다, 감당하다	감각과 지각
bearable	참을 만한, 견딜 만한	감정과 상태
